....................................................................................................
....................................................................................................
....................................................................................................
....................................................................................................
....................................................................................................
...........................EGGD.....................................................................
.......................EGGGRTT>.....................................................................
.................EGGGGGRTTTTTTLD.................................................EGGD.................
..............EGGRTTTTTTTTTTTTT>.............................................EGGGRTT>.................
..........EGGGRTTTTTTTTTTTTTTTTLD.....................................EGGGGGGRTTTTTT>.................
......EGGGRTTTTTTTTTTTTTTTTTTTTTLD...............................EGGGGRTTTTTTTTTTTTT>.................
GGGGGGRTTTTTTTTTTTTTTTTTTTTTTTTTTLGGGGGGGGGGGGGGGGGGGGGGGGGGGGGGGRTTTTTTTTTTTTTTTTTTLGGGGGGGGGGGGGGG
TTTTTTTTTTTTTTTTTTTTTTTTTTTTTTTTTTTTTTTTTTTTTTTTTTTTTTTTTTTTTTTTTTTTTTTTTTTTTTTTTTTTTTTTTTTTTTTTTTTT
TTTTTTTTTTTTTTTTTTTTTTTTTTTTTTTTTTTTTTTTTTTTTTTTTTTTTTTTTTTTTTTTTTTTTTTTTTTTTTTTTTTTTTTTTTTTTTTTTTTT
TTTTTTTTTTTTTTTTTTTTTTTTTTTTTTTTTTTTTTTTTTTTTTTTTTTTTTTTTTTTTTTTTTTTTTTTTTTTTTTTTTTTTTTTTTTTTTTTTTTT