....................................................................................................
....................................................................................................
..................................GGG...............................................................
...............................GGGGGGGG..............................................................
............................GGGGTTTTGGG..............................................................
..........................EGGGGTTTTTGGGD.............................................................
.......................EGGGGGRTTTTTTTT>..............................................................
....................EGGGGGGRTTTTTTTTTTLD.............................................EGGGD..........
.................EGGGGRTTTTTTTTTTTTTTTTT>.......................................EGGGGRTTT>...........
............EGGGGRTTTTTTTTTTTTTTTTTTTTTTLD.................................EGGGGGGRTTTTTT>..........
.........EGGGRTTTTTTTTTTTTTTTTTTTTTTTTTTTLD...........................EGGGGGRTTTTTTTTTTTTT>.........
....EGGGGRTTTTTTTTTTTTTTTTTTTTTTTTTTTTTTTTLGGGGGGGGGGGGGGGGGGGGGGGGGRTTTTTTTTTTTTTTTTTTTTTTLGGGGGGGG
GGGGGGRTTTTTTTTTTTTTTTTTTTTTTTTTTTTTTTTTTTTTTTTTTTTTTTTTTTTTTTTTTTTTTTTTTTTTTTTTTTTTTTTTTTTTTTTTTTTG
TTTTTTTTTTTTTTTTTTTTTTTTTTTTTTTTTTTTTTTTTTTTTTTTTTTTTTTTTTTTTTTTTTTTTTTTTTTTTTTTTTTTTTTTTTTTTTTTTTTT
TTTTTTTTTTTTTTTTTTTTTTTTTTTTTTTTTTTTTTTTTTTTTTTTTTTTTTTTTTTTTTTTTTTTTTTTTTTTTTTTTTTTTTTTTTTTTTTTTTTT
TTTTTTTTTTTTTTTTTTTTTTTTTTTTTTTTTTTTTTTTTTTTTTTTTTTTTTTTTTTTTTTTTTTTTTTTTTTTTTTTTTTTTTTTTTTTTTTTTTTT
