................................................................................................................................................
................................................................................................................................................
................................................................................................................................................
................................................................................................................................................
................................................................................................................................................
.........................O......................................................................................................................
.......................EGGGD....................................................................................................................
.......................evvvd....................................................................................................................
................................................................................................................................................
..............EGGD...EGGGGGGGD...EGGGGGD........................................................................................................
...........EGGRTT>...<TTTTTTT>...<TTTTTLGD......................................................................................................
GGGGGGGGGGGRTTTTT>...<TTTTTTT>...<TTTTTTTLGGGGGGD...EGGGGGGGGGGGGGGGGGGGGGGGGGGGGGGGGGGGGGGGGGGGGGGGGGGGGGGD...EGGGGGGGGGGGGGGGGGGGGGGGGGGGGGGGG
TTTTTTTTTTTTTTTTT>...<TTTTTTT>...<TTTTTTTTTTTTTT>...<......................................................>...<TTTTTTTTTTTTTTTTTTTTTTTTTTTTTTTT
TTTTTTTTTTTTTTTTT>...<TTTTTTT>...<TTTTTTTTTTTTTT>...<......................................................>...<TTTTTTTTTTTTTTTTTTTTTTTTTTTTTTTT
TTTTTTTTTTTTTTTTT>...<TTTTTTT>...<TTTTTTTTTTTTTT>...<......................................................>...<TTTTTTTTTTTTTTTTTTTTTTTTTTTTTTTT
TTTTTTTTTTTTTTTTT>...<TTTTTTT>...<TTTTTTTTTTTTTT>...<......................................................>...<TTTTTTTTTTTTTTTTTTTTTTTTTTTTTTTT
TTTTTTTTTTTTTTTTT>...<TTTTTTT>...<TTTTTTTTTTTTTT>...<......................................................>...<TTTTTTTTTTTTTTTTTTTTTTTTTTTTTTTT
TTTTTTTTTTTTTTTTT>...<TTTTTTT>...<TTTTTTTTTTTTTT>...<......................................................>...<TTTTTTTTTTTTTTTTTTTTTTTTTTTTTTTT
TTTTTTTTTTTTTTTTT>...<TTTTTTT>...<TTTTTTTTTTTTTT>...<......................................................>...<TTTTTTTTTTTTTTTTTTTTTTTTTTTTTTTT
TTTTTTTTTTTTTTTTT>...<TTTTTTT>...<TTTTTTTTTTTTTT>...<...........................O..........................>...<TTTTTTTTTTTTTTTTTTTTTTTTTTTTTTTT
TTTTTTTTTTTTTTTTT>...<TTTTTTT>...<TTTTTTTTTTTTTT>...<.........................EGGGD........................>...<TTTTTTTTTTTTTTTTTTTTTTTTTTTTTTTT
TTTTTTTTTTTTTTTTT>...<TTTTTTT>...<TTTTTTTTTTTTTT>.............................evvvd............................<TTTTTTTTTTTTTTTTTTTTTTTTTTTTTTTT
TTTTTTTTTTTTTTTTT>...<TTTTTTT>...<TTTTTTTTTTTTTT>..............................................................<TTTTTTTTTTTTTTTTTTTTTTTTTTTTTTTT
TTTTTTTTTTTTTTTTT>...<TTTTTTT>...<TTTTTTTTTTTTTTLGGGGGGGGGGGGGGGGGGGGGGGGGGGGGGGGGGGGGGGGGGGGGGGGGGGGGGGGGGGGGGRTTTTTTTTTTTTTTTTTTTTTTTTTTTTTTTT
