........................................................................................................................
........................................................................................................................
........................................................................................................................
........................................................................................................................
........................................................................................................................
.........................O..............................................................................................
.......................EGGGD............................................................................................
.......................evvvd............................................................................................
........................................................................................................................
..............EGGD...EGGGGGGGD...EGGGGGD................................................................................
...........EGGRTT>...<TTTTTTT>...<TTTTTLGD..............................................................................
GGGGGGGGGGGRTTTTT>...<TTTTTTT>...<TTTTTTTLGGGGGGD...EGGGGGGGGGGGGGGGGGGGGGGGGGGGGGGGGGGGGGGGGGGGGGGGGGGGGGGGGGGGGGGGGGGG
TTTTTTTTTTTTTTTTT>...<TTTTTTT>...<TTTTTTTTTTTTTT>...<..........................................................TTTTTTTTT
TTTTTTTTTTTTTTTTT>...<TTTTTTT>...<TTTTTTTTTTTTTT>...<..........................................................TTTTTTTTT
TTTTTTTTTTTTTTTTT>...<TTTTTTT>...<TTTTTTTTTTTTTT>...<..........................................................TTTTTTTTT
TTTTTTTTTTTTTTTTT>...<TTTTTTT>...<TTTTTTTTTTTTTT>...<..........................................................TTTTTTTTT
TTTTTTTTTTTTTTTTT>...<TTTTTTT>...<TTTTTTTTTTTTTT>...<..........................................................TTTTTTTTT
TTTTTTTTTTTTTTTTT>...<TTTTTTT>...<TTTTTTTTTTTTTT>...<..........................................................TTTTTTTTT
TTTTTTTTTTTTTTTTT>...<TTTTTTT>...<TTTTTTTTTTTTTT>...<..........................................................TTTTTTTTT
TTTTTTTTTTTTTTTTT>...<TTTTTTT>...<TTTTTTTTTTTTTT>...<..........................................................TTTTTTTTT
TTTTTTTTTTTTTTTTT>...<TTTTTTT>...<TTTTTTTTTTTTTT>...<..........................................................TTTTTTTTT
TTTTTTTTTTTTTTTTT>...<TTTTTTT>...<TTTTTTTTTTTTTT>..............................................................TTTTTTTTT
TTTTTTTTTTTTTTTTT>...<TTTTTTT>...<TTTTTTTTTTTTTT>..............................................................TTTTTTTTT
TTTTTTTTTTTTTTTTT>...<TTTTTTT>...<TTTTTTTTTTTTTTLGGGGGGGGGGGGGGGGGGGGGGGGGGGGGGGGGGGGGGGGGGGGGGGGGGGGGGGGGGGGGGTTTTTTTTT
