....................................................................................................
....................................................................................................
....................................................................................................
....................................................................................................
............................O.......................................................................
...........................EGGD.....................................................................
.......................EGGGRTT>...................................................O.................
.................EGGGGGRTTTTTTLD.................................................EGGD.................
..............EGGRTTTTTTTTTTTTT>.............................................EGGGRTT>.................
..........EGGGRTTTTTTTTTTTTTTTTLD.....................................EGGGGGGRTTTTTT>.................
......EGGGRTTTTTTTTTTTTTTTTTTTTTLD...............O...............EGGGGRTTTTTTTTTTTTT>.................
GGGGGGRTTTTTTTTTTTTTTTTTTTTTTTTTTLGGGGGGGGGGGGGGGGGGGGGGGGGGGGGGGRTTTTTTTTTTTTTTTTTTLGGGGGGGGGGGGGGG
TTTTTTTTTTTTTTTTTTTTTTTTTTTTTTTTTTTTTTTTTTTTTTTTTTTTTTTTTTTTTTTTTTTTTTTTTTTTTTTTTTTTTTTTTTTTTTTTTTTT
TTTTTTTTTTTTTTTTTTTTTTTTTTTTTTTTTTTTTTTTTTTTTTTTTTTTTTTTTTTTTTTTTTTTTTTTTTTTTTTTTTTTTTTTTTTTTTTTTTTT
TTTTTTTTTTTTTTTTTTTTTTTTTTTTTTTTTTTTTTTTTTTTTTTTTTTTTTTTTTTTTTTTTTTTTTTTTTTTTTTTTTTTTTTTTTTTTTTTTTTT